1111111111111
1001000010P01
10C0000010001
1110000000001
1011111110001
1010E01000C01
1010000000001
1111111111111