1111111111111111111111111111
1E01000000000000000000000001
1001P00000000000011111100001
10000000000000000100C0000001
1111111110000000011111111111
1000000000010000010000000001
1111110000001000010000000001
10000C000000011000000C000001
1111111111111111111111111111