11111111
1P000011
10111E01
100C1101
11111111